교사(敎唆) : 남을 꾀거나 부추겨서 나쁜 짓을 하게 함.
간과(看過) : 큰 관심 없이 대강 보아 넘김.
간주(看做) : 상태, 모양, 성질 따위가 그와 같다고 봄. 또는 그렇다고 여김.
갈등(葛藤) : 1.칡과 등나무가 서로 얽히는 것과 같이, 개인이나 집단 사이에 목표나 이해관계가 달라 ...	2.문학소설이나 희곡에서, 등장인물 사이에 일어나는 대립과 충돌 또는 등장인물과 환...	3.심리두 가지 이상의 상반되는 요구나 욕구, 기회 또는 목표에 직면하였을 때, 선택을 ...	
개전(改悛) : 행실이나 태도의 잘못을 뉘우치고 마음을 바르게 고쳐먹음.
개진(開陣) : 군사를 철수하고 진영을 열어 놓음.
견제(牽制) : 1.일정한 작용을 가함으로써 상대편이 지나치게 세력을 펴거나 자유롭게 행동하지 못하게 억누름.	2.군사아군의 공격이 수월하도록 적의 일부를 다른 곳에 묶어 두는 전술적 행동.	
결벽(潔癖) : 1.유난스럽게 깨끗한 것을 좋아하는 성벽(性癖).	2.악하고 그릇된 일을 극단적으로 미워하는 성질.	
경직(硬直) : 1.몸 따위가 굳어서 뻣뻣하게 됨. ‘굳음’으로 순화.	2.사고방식, 태도, 분위기 따위가 부드럽지 못하여 융통성이 없고 엄격하게 됨.	3.의학근육이 수축하여 굳어지는 일.	
고갈(枯渴) : 1.물이 말라서 없어짐.	2.어떤 일의 바탕이 되는 돈이나 물자, 소재, 인력 따위가 다하여 없어짐.	3.느낌이나 생각 따위가 다 없어짐.	
고루(固陋) : 낡은 관념이나 습관에 젖어 고집이 세고 새로운 것을 잘 받아들이지 아니하다
고무(鼓舞) : 1.북을 치고 춤을 춤.	2.힘을 내도록 격려하여 용기를 북돋움.	
고취(鼓吹) : 1.[같은 말] 고무3(鼓舞)(1. 북을 치고 춤을 춤).	2.[같은 말] 고무3(2. 힘을 내도록 격려하여 용기를 북돋움).	3.의견이나 사상 따위를 열렬히 주장하여 불어넣음.	
관건(關鍵) : 1.문빗장과 자물쇠를 아울러 이르는 말.	2.어떤 사물이나 문제 해결의 가장 중요한 부분.	
관망(觀望) : 1.한발 물러나서 어떤 일이 되어 가는 형편을 바라봄.	2.풍경 따위를 멀리서 바라봄.	
관조(觀照) : 1.고요한 마음으로 사물이나 현상을 관찰하거나 비추어 봄.	2.예술미(美)를 직접적으로 인식하는 일.	3.불교지혜로 모든 사물의 참모습과 나아가 영원히 변하지 않는 진리를 비추어 봄.	
괴리(乖離) : 서로 어그러져 동떨어짐.
교란(攪亂) : 마음이나 상황 따위를 뒤흔들어서 어지럽고 혼란하게 함. ‘어지럽힘’, ‘혼란스럽게 만듦’으로 순화.
구사(驅使) : 1.사람이나 동물을 함부로 몰아쳐 부림.	2.말이나 수사법, 기교, 수단 따위를 능숙하게 마음대로 부려 씀.	
귀의(歸依) : 1.돌아가거나 돌아와 몸을 의지함.	2.불교부처와 불법(佛法)과 승가(僧伽)로 돌아가 의지하여 구원을 청함. 불교 신앙의 근...	3.종교몰아의 경지에서 종교적 절대자나 종교적 진리를 깊이 믿고 의지하는 일.	
규탄(糾彈) : 잘못이나 옳지 못한 일을 잡아내어 따지고 나무람.
금기(禁忌) : 1.마음에 꺼려서 하지 않거나 피함.	2.의학어떤 약이나 치료법이 특정 환자에게 나쁜 영향이 있는 경우에 그 사용을 금지하는 일.	
긍휼(矜恤) : 불쌍히 여겨 돌보아 줌.
기여(寄與) : 1.도움이 되도록 이바지함.	2.물건을 부쳐 줌.	
기치(旗幟) : 1.예전에, 군대에서 쓰던 깃발.	2.일정한 목적을 위하여 내세우는 태도나 주장.	3.기에 나타난 표지(標識).	
기탄(忌憚) : 어렵게 여겨 꺼림.
기피(忌避) : 1.꺼리거나 싫어하여 피함.	2.법률법관, 법원 직원 따위가 한쪽 소송 관계인과 특수한 관계에 있거나 어떠한 사정으...	
기호(嗜好) : 즐기고 좋아함.
나락(奈落) : 1.불교[같은 말] 지옥(2. 죄업을 짓고 매우 심한 괴로움의 세계에 난 중생이나 그런 중생의 세계).	2.벗어나기 어려운 절망적인 상황을 비유적으로 이르는 말.	
나태(懶怠) : 행동, 성격 따위가 느리고 게으름.
낙인(烙印) : 1.쇠붙이로 만들어 불에 달구어 찍는 도장. 목재나 기구, 가축 따위에 주로 찍고 예전에는 ...	2.다시 씻기 어려운 불명예스럽고 욕된 판정이나 평판을 이르는 말.	
날조(捏造) : 1.사실이 아닌 것을 사실인 것처럼 거짓으로 꾸밈.	2.[북한어]불법 단체나 기구를 만듦.	
남루(襤褸) : 낡아 해진 옷.
눌변(訥辯) : 더듬거리는 서툰 말솜씨.
대두(擡頭) : 1.머리를 쳐든다는 뜻으로, 어떤 세력이나 현상이 새롭게 나타남을 이르는 말.	2.글을 쓸 때에, 경의(敬意)를 나타내기 위하여 줄을 바꾸어 쓰되, 다른 줄보다 몇 자 올리...	
대치(對峙) : 서로 맞서서 버팀.
도야(陶冶) : 1.도기를 만드는 일과 쇠를 주조하는 일. 또는 그런 일을 하는 사람.	2.훌륭한 사람이 되도록 몸과 마음을 닦아 기름을 비유적으로 이르는 말.	
도탄(塗炭) : 진구렁에 빠지고 숯불에 탄다는 뜻으로, 몹시 곤궁하여 고통스러운 지경을 이르는 말.
도태(淘汰) : 1.물건을 물에 넣고 일어서 좋은 것만 골라내고 불필요한 것을 가려서 버림.	2.여럿 중에서 불필요하거나 부적당한 것을 줄여 없앰.	
독직(瀆職) : 어떤 직책에 있는 사람이 그 직책을 더럽힘. 특히, 공무원이 그 지위나 직권을 남용하여 뇌물을 받는 따위의 부정한 행위를 저지르는 것을 이른다.
두절(杜絶) : 교통이나 통신 따위가 막히거나 끊어짐.
만류(挽留) : 붙들고 못 하게 말림.
매개(媒介) : 1.둘 사이에서 양편의 관계를 맺어 줌.	2.논리서로 떨어져 있는 두 명사 사이에서 두 명사의 관계를 맺어 주는 중간 항의 명사...	3.철학헤겔의 변증법에서, 어떤 사물이 존재할 조건이 되는 일. 모든 사물이 따로 독립...	
매도(罵倒) : 심하게 욕하며 나무람. ‘꾸짖음’, ‘욕함’으로 순화.
매몰(埋沒) : 보이지 아니하게 파묻히거나 파묻음.
매진(邁進) : 어떤 일을 전심전력을 다하여 해 나감.
맹아(萌芽) : 1.[같은 말] 움1(1. 풀이나 나무에 새로 돋아 나오는 싹). ‘움1’으로 순화.	2.사물의 시초가 되는 것.	
모독(冒瀆) : 말이나 행동으로 더럽혀 욕되게 함.
모색(摸索) : 일이나 사건 따위를 해결할 수 있는 방법이나 실마리를 더듬어 찾음.
모호(模糊) : 말이나 태도가 흐리터분하여 분명하지 않다
몽매(蒙昧) : 어리석고 사리에 어두움.
미봉(彌縫) : 일의 빈 구석이나 잘못된 것을 임시변통으로 이리저리 주선하여 꾸며 댐.
미혹(迷惑) : 1.무엇에 홀려 정신을 차리지 못함.	2.정신이 헷갈리어 갈팡질팡 헤맴.	
민망(憫惘) : 답답하고 딱하여 안타깝다
박식(博識) : 지식이 넓고 아는 것이 많음.
박탈(剝奪) : 남의 재물이나 권리, 자격 따위를 빼앗음.
반추(反芻) : 1.동물한번 삼킨 먹이를 다시 게워 내어 씹음. 또는 그런 일. 소나 염소 따위와 같이 소...	2.어떤 일을 되풀이하여 음미하거나 생각함. 또는 그런 일.	
발군(拔群) : 여럿 가운데에서 특별히 뛰어남.
발췌(拔萃) : 1.책, 글 따위에서 필요하거나 중요한 부분을 가려 뽑아냄. 또는 그런 내용.	2.[같은 말] 발군1(拔群)(여럿 가운데에서 특별히 뛰어남).	
방조(幇助) : 법률 형법에서, 남의 범죄 수행에 편의를 주는 모든 행위. 정범(正犯)의 범죄 행위에 대한 조언, 격려, 범행 도구의 대여, 범행 장소 및 범행 자금의 제공 따위가 있다.
배태(胚胎) : 1.아이나 새끼를 뱀.	2.어떤 현상이나 사물이 발생하거나 일어날 원인을 속으로 가짐. ‘싹 틈’으로 순화.	
번뇌(煩惱) : 1.마음이 시달려서 괴로워함. 또는 그런 괴로움.	2.불교마음이나 몸을 괴롭히는 노여움이나 욕망 따위의 망념(妄念).	
복선(伏線) : 1.만일의 경우에 대비하여 남모르게 미리 꾸며 놓은 일.	2.문학소설이나 희곡 따위에서, 앞으로 일어날 사건을 미리 독자에게 넌지시 암시하는 서술.	
부각(浮刻) : 1.어떤 사물을 특징지어 두드러지게 함.	2.미술[같은 말] 돋을새김(조각에서, 평평한 면에 글자나 그림 따위를 도드라지게 새기는 일).	
부심(腐心) : 1.근심, 걱정으로 마음이 썩음.	2.어떤 문제를 해결하기 위한 방안을 생각해 내느라고 몹시 애씀.	
부연(敷衍) : 1.이해하기 쉽도록 설명을 덧붙여 자세히 말함.	2.늘려서 널리 폄.	
분쇄(粉碎) : 1.단단한 물체를 가루처럼 잘게 부스러뜨림.	2.여지없이 공격하여 무찌름.	
불후(不朽) : 썩지 아니함이라는 뜻으로, 영원토록 변하거나 없어지지 아니함을 비유적으로 이르는 말.
비등(沸騰) : 1.화학액체가 끓어오름. 액체가 어느 온도 이상으로 가열되어, 그 증기압이 주위의 압력...	2.물이 끓듯 떠들썩하게 일어남.	3.[북한어]열정, 정열, 기세 따위가 끓어 넘침.	
비상(飛翔) : 공중을 낢. ‘날기’로 순화.
비수(匕首) : 날이 예리하고 짧은 칼.
비호(庇護) : 편들어서 감싸 주고 보호함.
사주(使嗾) : 남을 부추겨 좋지 않은 일을 시킴.
삼매(三昧) : 1. 잡념을 떠나서 오직 하나의 대상에만 정신을 집중하는 경지. 이 경지에서 바른 지혜를 ...     2. [같은 말] 삼마야(2. 어느 한때라는 뜻으로, 경전의 첫머리에 쓰는 말). 
서식(棲息) : 생물 따위가 일정한 곳에 자리를 잡고 삶.
선망(羨望) : 부러워하여 바람.
소급(遡及) : 과거에까지 거슬러 올라가서 미치게 함.
소생(蘇生) : 거의 죽어 가다가 다시 살아남.
소요(騷擾) : 1.여럿이 떠들썩하게 들고일어남. 또는 그런 술렁거림과 소란.	2.법률여러 사람이 모여 폭행이나 협박 또는 파괴 행위를 함으로써 공공질서를 문란하...	
소탕(掃蕩) : 휩쓸어 죄다 없애 버림.
수려(秀麗) : 빼어나게 아름답다
수반(隨伴) : 1.붙좇아서 따름.	2.어떤 일과 더불어 생김.	
수작(酬酌) : 1.술잔을 서로 주고받음.	2.서로 말을 주고받음. 또는 그 말.	3.남의 말이나 행동, 계획을 낮잡아 이르는 말.	
시기(猜忌) : 남이 잘되는 것을 샘하여 미워함.
시사(示唆) : 어떤 것을 미리 간접적으로 표현해 줌. ‘귀띔’, ‘암시1’, ‘일러 줌’으로 순화.
알력(軋轢) : 수레바퀴가 삐걱거린다는 뜻으로, 서로 의견이 맞지 아니하여 사이가 안 좋거나 충돌하는 것을 이르는 말.
알선(斡旋) : 1.남의 일이 잘되도록 주선하는 일.	2.법률예전에, 노동 쟁의를 조정하던 제도의 하나. 노동 위원회가 위촉한 알선 위원은 ...	3.법률장물인 줄 알면서도 매매를 주선하고 수수료를 받는 행위.	
야기(惹起) : 일이나 사건 따위를 끌어 일으킴.
야합(野合) : 1.부부가 아닌 남녀가 서로 정을 통함.	2.좋지 못한 목적으로 서로 어울림.	
여과(濾過) : 1.거름종이나 여과기를 써서 액체 속에 들어 있는 침전물이나 입자를 걸러 내는 일.	2.주로 부정적인 요소를 걸러 내는 과정을 비유적으로 이르는 말.	
영전(榮轉) : 전보다 더 좋은 자리나 직위로 옮김.
예속(隸屬) : 1.남의 지배나 지휘 아래 매임.	2.윗사람에게 매여 있는 아랫사람.	
예지(叡智) : 사물의 이치를 꿰뚫어 보는 지혜롭고 밝은 마음.
와전(訛傳) : 사실과 다르게 전함.
완곡(婉曲) : 말하는 투가, 듣는 사람의 감정이 상하지 않도록 모나지 않고 부드럽다
완충(緩衝) : 대립하는 것 사이에서 불화나 충돌을 누그러지게 함.
왜곡(歪曲) : 사실과 다르게 해석하거나 그릇되게 함.
요절(夭折) : 젊은 나이에 죽음.
용이(容易) : 어렵지 아니하고 매우 쉽다
유괴(誘拐) : 사람을 속여서 꾀어냄.
유대(紐帶) : 끈과 띠라는 뜻으로, 둘 이상을 서로 연결하거나 결합하게 하는 것. 또는 그런 관계.
유리(遊離) : 1.따로 떨어짐.	2.화학화합물에서 결합이 끊어져 원자나 원자단이 분리되는 일. 또는 원자나 원자단이 ...	
유린(蹂躪) : 남의 권리나 인격을 짓밟음.
유발(誘發) : 어떤 것이 다른 일을 일어나게 함.
유사(類似) : 서로 비슷함.
유착(癒着) : 1.사물들이 서로 깊은 관계를 가지고 결합하여 있음. ‘엉겨 붙기’로 순화.	2.의학서로 분리되어 있어야 할 생물체의 조직면이 섬유소나 섬유 조직 따위와 연결되...	
윤곽(輪廓) : 1.일이나 사건의 대체적인 줄거리.	2.사물의 테두리나 대강의 모습.	
융성(隆盛) : 기운차게 일어나거나 대단히 번성함.
은둔(隱遁) : 세상일을 피하여 숨음.
은폐(隱蔽) : 1.덮어 감추거나 가리어 숨김.	2.군사적에게 관측되지 아니하도록 주변의 지형지물을 이용하여 인원이나 장비, 시설 ...	3.군사[같은 말] 은폐물(적의 관측으로부터 인원, 기재 따위를 숨기는 데 쓰는 물체).	
이식(移植) : 1.[같은 말] 옮겨심기(식물 따위를 옮겨 심음). ‘옮겨심기’로 순화.	2.의학살아 있는 조직이나 장기를 생체로부터 떼어 내어, 같은 개체의 다른 부분 또는 ...	
이완(弛緩) : 1.바짝 조였던 정신이 풀려 늦추어짐.	2.잘 조성된 분위기 따위가 흐트러져 느슨해짐.	3.굳어서 뻣뻣하게 된 근육 따위가 원래의 상태로 풀어짐.	
일관(一貫) : 하나의 방법이나 태도로써 처음부터 끝까지 한결같음.
잉여(剩餘) : 1.쓰고 난 후 남은 것. ‘나머지’로 순화.	2.수학‘나머지’의 전 용어.	
자행(恣行) : 1.제멋대로 해 나감. 또는 삼가는 태도가 없이 건방지게 행동함.	2.함부로 유행함.	
잠재(潛在) : 겉으로 드러나지 않고 속에 잠겨 있거나 숨어 있음.
저간(這間) : 바로 얼마 전부터 이제까지의 무렵.
저주(詛呪) : 남에게 재앙이나 불행이 일어나도록 빌고 바람. 또는 그렇게 하여서 일어난 재앙이나 불행.
저해(沮害) : 막아서 못하도록 해침.
전가(轉嫁) : 1.잘못이나 책임을 다른 사람에게 넘겨씌움.	2.시집을 두 번째로 감.	3.경제조세 부담이 사경제적(私經濟的)인 유통 과정을 통하여 납세자로부터 다른 곳으로 이전됨.	
전율(戰慄) : 1.몹시 무섭거나 두려워 몸이 벌벌 떨림.	2.몸이 떨릴 정도로 감격스러움을 비유적으로 이르는 말.	
전파(傳播) : 1.전하여 널리 퍼뜨림.	2.물리파동이 매질(媒質) 속을 퍼져 가는 일.	
절찬(絶讚) : 지극히 칭찬함. 또는 그런 칭찬.
정곡(正鵠) : 1.과녁의 한가운데가 되는 점.	2.가장 중요한 요점 또는 핵심.	3.조금도 틀림없이 바로.	
정밀(靜謐) : 고요하고 편안함.
제패(制覇) : 1.패권을 잡음.	2.경기 따위에서 우승함.	
제휴(提携) : 행동을 함께하기 위하여 서로 붙들어 도와줌.
조망(眺望) : 먼 곳을 바라봄. 또는 그런 경치.
조예(造詣) : 학문이나 예술, 기술 따위의 분야에 대한 지식이나 경험이 깊은 경지에 이른 정도.
주술(呪術) : 불행이나 재해를 막으려고 주문을 외거나 술법을 부리는 일. 또는 그 술법.
주창(主唱) : 1.주의나 사상을 앞장서서 주장함.	2.노래나 시 따위를 앞장서서 부름.	
주효(酒肴) : 술과 안주를 아울러 이르는 말.
준동(蠢動) : 벌레 따위가 꿈적거린다는 뜻으로, 불순한 세력이나 보잘것없는 무리가 법석을 부림을 이르는 말.
지양(止揚) : 1.더 높은 단계로 오르기 위하여 어떠한 것을 하지 아니함. ‘피함’, ‘하지 않음’으로 순화.	2.철학변증법의 중요한 개념으로, 어떤 것을 그 자체로는 부정하면서 오히려 한층 더 높...	
진부(陳腐) : 사상, 표현, 행동 따위가 낡아서 새롭지 못하다
진척(進陟) : 1.일이 목적한 방향대로 진행되어 감.	2.벼슬이 높아짐.	
질곡(桎梏) : 1.옛 형구인 차꼬와 수갑을 아울러 이르는 말.	2.몹시 속박하여 자유를 가질 수 없는 고통의 상태를 비유적으로 이르는 말.	
착복(着服) : 1.[같은 말] 복착(옷을 입음).	2.남의 금품을 부당하게 자기 것으로 함.	
착취(搾取) : 1.계급 사회에서 생산 수단을 소유한 사람이 생산 수단을 갖지 않은 직접 생산자로부터 그...	2.동물의 젖이나 식물의 즙을 꼭 누르거나 비틀어서 짜냄.	
참소(讒訴) : 남을 헐뜯어서 죄가 있는 것처럼 꾸며 윗사람에게 고하여 바침.
참신(斬新) : 새롭고 산뜻하다
참회(懺悔) : 1.자기의 잘못에 대하여 깨닫고 깊이 뉘우침.	2.불교과거의 죄를 뉘우치고 부처, 보살, 사장(師長), 대중 앞에 고백하여 용서를 구함.	3.종교신이나 부처 앞에서 자기의 죄를 회개하고 용서를 빎.	
척결(剔抉) : 1.살을 도려내고 뼈를 발라냄.	2.나쁜 부분이나 요소들을 깨끗이 없애 버림.	
천명(闡明) : 진리나 사실, 입장 따위를 드러내어 밝힘.
천착(穿鑿) : 1.구멍을 뚫음.	2.어떤 원인이나 내용 따위를 따지고 파고들어 알려고 하거나 연구함.	3.억지로 이치에 닿지 아니한 말을 함.	
첨예(尖銳) : 1. 날카롭고 뾰족하다.	2. 상황이나 사태 따위가 날카롭고 격하다. 
첩경(捷徑) : 1.[같은 말] 지름길(1. 멀리 돌지 않고 가깝게 질러 통하는 길).	2.[같은 말] 지름길(2. 가장 쉽고 빠른 방법을 비유적으로 이르는 말).	
촉진(促進) : 다그쳐 빨리 나아가게 함.
추대(推戴) : 윗사람으로 떠받듦.
추출(抽出) : 1.전체 속에서 어떤 물건, 생각, 요소 따위를 뽑아냄.	2.수학모집단(母集團)에서 표본을 뽑아내는 일.	3.화학고체 또는 액체의 혼합물에 용매(溶媒)를 가하여 혼합물 속의 어떤 물질을 용매에...	
추호(秋毫) : 1.가을철에 털갈이하여 새로 돋아난 짐승의 가는 털.	2.매우 적거나 조금인 것을 비유적으로 이르는 말.	
출중(出衆) : 여러 사람 가운데서 특별히 두드러지다
취약(脆弱) : 무르고 약함.
치명(致命) : 1.죽을 지경에 이름.	2.가톨릭가톨릭에서, 예전에 ‘순교3’를 이르던 말.	
치부(置簿) : 1.금전이나 물건 따위가 들어오고 나감을 기록함. 또는 그런 장부.	2.마음속으로 그러하다고 보거나 여김.	
치졸(稚拙) : 유치하고 졸렬함.
칩거(蟄居) : 나가서 활동하지 아니하고 집 안에만 틀어박혀 있음.
타당(妥當) : 일의 이치로 보아 옳다
타파(打破) : 부정적인 규정, 관습, 제도 따위를 깨뜨려 버림.
탄로(綻露) : 숨긴 일을 드러냄.
탄핵(彈劾) : 1.죄상을 들어서 책망함.	2.법률보통의 파면 절차에 의한 파면이 곤란하거나 검찰 기관에 의한 소추(訴追)가 사실...	
탐닉(耽溺) : 1.어떤 일을 몹시 즐겨서 거기에 빠짐.	2.약학약물의 반복 사용으로 의존성이 생겨 신체적으로 약물에 의존하지 않고는 정상적...	
탕감(蕩減) : 빚이나 요금, 세금 따위의 물어야 할 것을 삭쳐 줌. ‘덜어 줌’, ‘아주 덜어 줌’으로 순화.
태동(胎動) : 1.의학모태 안에서의 태아의 움직임.	2.한의학[같은 말] 태동불안(임신 중에 태아가 빈번하게 움직여서 배가 아프고 당기는 ...).	3.어떤 일이 생기려는 기운이 싹틈.	
터득(攄得) : 깊이 생각하여 이치를 깨달아 알아냄.
통찰(洞察) : 1.예리한 관찰력으로 사물을 꿰뚫어 봄.	2.심리새로운 사태에 직면하여 장면의 의미를 재조직화함으로써 갑작스럽게 문제를 해...	3.심리심리 치료에서, 환자가 이전에는 인식하지 못하였던 자신의 심적 상태를 알게 되는 일.	
퇴색(退色) : 1.빛이나 색이 바램.	2.무엇이 낡거나 몰락하면서 그 존재가 희미해지거나 볼품없이 됨을 비유적으로 이르는 말.	
퇴영(退嬰) : 1.뒤로 물러나서 가만히 틀어박혀 있음.	2.활기나 진취적 기상이 없게 됨.	3.뒷걸음질을 침.	
퇴조(退潮) : 1.기운, 세력 따위가 줄어듦.	2.지리[같은 말] 썰물(조수의 간만으로 해면이 하강하는 현상).	
투기(投機) : 1.기회를 틈타 큰 이익을 보려고 함. 또는 그 일.	2.경제시세 변동을 예상하여 차익을 얻기 위하여 하는 매매 거래.	
파국(破局) : 1.일이나 사태가 잘못되어 결딴이 남. 또는 그 판국.	2.약국을 그만둠.	3.문학희곡에서, 비극적인 결말을 이르는 말.	
파탄(破綻) : 1.찢어져 터짐.	2.일이나 계획 따위가 원만하게 진행되지 못하고 중도에서 잘못됨.	3.경제상점, 회사 따위의 재정이 지급 정지의 상태가 됨.	
팽배(澎湃) : 1.큰 물결이 맞부딪쳐 솟구침.	2.어떤 기세나 사조 따위가 매우 거세게 일어남.	
편향(偏向) : 1.한쪽으로 치우침.	2.물리대전(帶電) 입자의 비행 방향을 전기장이나 자기장을 가하여 변화시킴.	
포착(捕捉) : 1.꼭 붙잡음.	2.요점이나 요령을 얻음.	3.어떤 기회나 정세를 알아차림.	
표절(剽竊) : 시나 글, 노래 따위를 지을 때에 남의 작품의 일부를 몰래 따다 씀.
풍미(風靡) : 바람에 초목이 쓰러진다는 뜻으로, 어떤 사회적 현상이나 사조 따위가 널리 사회에 퍼짐을 이르는 말.
풍자(諷刺) : 1.남의 결점을 다른 것에 빗대어 비웃으면서 폭로하고 공격함.	2.문학 작품 따위에서, 현실의 부정적 현상이나 모순 따위를 빗대어 비웃으면서 씀.	
핍박(逼迫) : 1.형세가 절박함.	2.바싹 죄어서 몹시 괴롭게 굶.	
하자(瑕疵) : 1.옥의 얼룩진 흔적이라는 뜻으로, ‘흠3’을 이르는 말.	2.법률법률 또는 당사자가 예기한 상태나 성질이 결여되어 있는 일.	
해소(解消) : 1.어려운 일이나 문제가 되는 상태를 해결하여 없애 버림.	2.어떤 관계를 풀어서 없애 버림.	3.어떤 단체나 조직 따위를 없애 버림.	
해일(海溢) : 지리 해저의 지각 변동이나 해상의 기상 변화에 의하여 갑자기 바닷물이 크게 일어서 육지로 넘쳐 들어오는 것. 또는 그런 현상.
해학(諧謔) : 익살스럽고도 품위가 있는 말이나 행동.
해후(邂逅) : 오랫동안 헤어졌다가 뜻밖에 다시 만남.
향유(享有) : 누리어 가짐.
형극(荊棘) : 1.나무의 온갖 가시.	2.‘고난’을 비유적으로 이르는 말.	
혼선(混線) : 1.전신ㆍ전화ㆍ무선 통신 따위에서, 선이 서로 닿거나 전파가 뒤섞여 통신이 엉클어지는 일.	2.말이나 일 따위를 서로 다르게 파악하여 혼란이 생김.	3.줄이 갈피를 잡을 수 없게 뒤섞임. 또는 그 줄.	
혼신(渾身) : 몸 전체.
환기(喚起) : 주의나 여론, 생각 따위를 불러일으킴.
회귀(回歸) : 한 바퀴 돌아 제자리로 돌아오거나 돌아감.
회자(膾炙) : 회와 구운 고기라는 뜻으로, 칭찬을 받으며 사람의 입에 자주 오르내림을 이르는 말.
효시(嚆矢) : 1.[같은 말] 우는살(예전에, 전쟁 때에 쓰던 화살의 하나).	2.어떤 사물이나 현상이 시작되어 나온 맨 처음을 비유적으로 이르는 말. ≪장자≫의 재...	
훼손(毁損) : 1.체면이나 명예를 손상함.	2.헐거나 깨뜨려 못 쓰게 만듦.	
흠모(欽慕) : 기쁜 마음으로 공경하며 사모함.
흡사(恰似) : 거의 같을 정도로 비슷한 모양.
흡수(吸收) : 1.빨아서 거두어들임.	2.외부에 있는 사람이나 사물 따위를 내부로 모아들임.	3.물리전자기파나 입자선이 물질 속을 통과할 때 에너지나 입자가 물질에 빨려 들어 그 ...	
흥행(興行) : 1.영리를 목적으로 연극, 영화, 서커스 따위를 요금을 받고 대중에게 보여 줌.	2.공연 상영 따위가 상업적으로 큰 수익을 거둠.	
희생(犧牲) : 1.다른 사람이나 어떤 목적을 위하여 자신의 목숨, 재산, 명예, 이익 따위를 바치거나 버림...	2.사고나 자연 재해 따위로 애석하게 목숨을 잃음.	3.천지신명 따위에 제사 지낼 때 제물로 바치는, 산 짐승. 주로 소, 양, 돼지 따위를 바친다.	
희소(稀少) : 매우 드물고 적음.
힐책(詰責) : 잘못된 점을 따져 나무람. ‘꾸짖음’으로 순화.

가렴주구 : 세금을 가혹하게 거두어들이고, 무리하게 재물을 빼앗음.
각골난망 : 남에게 입은 은혜가 뼈에 새길 만큼 커서 잊히지 아니함.
각골통한 : 뼈에 사무칠 만큼 원통하고 한스러움. 또는 그런 일.
각주구검 : 융통성 없이 현실에 맞지 않는 낡은 생각을 고집하는 어리석음을 이르는 말. 초나라 사람이 배에서 칼을 물속에 떨어뜨리고 그 위치를 뱃전에 표시하였다가 나중에 배가 움직인 것...
감언이설 : 귀가 솔깃하도록 남의 비위를 맞추거나 이로운 조건을 내세워 꾀는 말. ‘꾐 말’, ‘달콤한 말’로 순화.
감탄고토 : 달면 삼키고 쓰면 뱉는다는 뜻으로, 자신의 비위에 따라서 사리의 옳고 그름을 판단함을 이르는 말.
거안제미 : 밥상을 눈썹과 가지런하도록 공손히 들어 남편 앞에 가지고 간다는 뜻으로, 남편을 깍듯이 공경함을 이르는 말.
건곤일척 : 주사위를 던져 승패를 건다는 뜻으로, 운명을 걸고 단판걸이로 승부를 겨룸을 이르는 말.
격물치지 : 실제 사물의 이치를 연구하여 지식을 완전하게 함. ≪대학≫에 나오는 말이다.
격화소양 : 신을 신고 발바닥을 긁는다는 뜻으로, 성에 차지 않거나 철저하지 못한 안타까움을 이르는 말.
견강부회 : 이치에 맞지 않는 말을 억지로 끌어 붙여 자기에게 유리하게 함.
견리사의 : 눈앞의 이익을 보면 의리를 먼저 생각함.
견원지간 : 개와 원숭이의 사이라는 뜻으로, 사이가 매우 나쁜 두 관계를 비유적으로 이르는 말.
결자해지 : 맺은 사람이 풀어야 한다는 뜻으로, 자기가 저지른 일은 자기가 해결하여야 함을 이르는 말.
결초보은 : 죽은 뒤에라도 은혜를 잊지 않고 갚음을 이르는 말. 중국 춘추 시대에, 진나라의 위과(魏顆)가 아버지가 세상을 떠난 후에 서모를 개가시켜 순사(殉死)하지 않게 하였더니, 그 뒤 싸...
경천근인 : 하늘을 공경하고 백성을 위하여 부지런히 일함.
경천동지 : 하늘을 놀라게 하고 땅을 뒤흔든다는 뜻으로, 세상을 몹시 놀라게 함을 비유적으로 이르는 말.
개과천선 : 지난날의 잘못이나 허물을 고쳐 올바르고 착하게 됨.
계세장인 : 세상 사람들을 경계하고 징벌함.
고육지계 : 자기 몸을 상해 가면서까지 꾸며 내는 계책이라는 뜻으로, 어려운 상태를 벗어나기 위해 어쩔 수 없이 꾸며 내는 계책을 이르는 말.
고장난명 : 1.외손뼉만으로는 소리가 울리지 아니한다는 뜻으로, 혼자의 힘만으로 어떤 일을 이루기 ...	2.맞서는 사람이 없으면 싸움이 일어나지 아니함을 이르는 말.	
고진감해 : 물가 따위가 높이 오름.
곡학아세 : 바른 길에서 벗어난 학문으로 세상 사람에게 아첨함.
공리공론 : 실천이 따르지 아니하는, 헛된 이론이나 논의.
과유불급 : 정도를 지나침은 미치지 못함과 같다는 뜻으로, 중용(中庸)이 중요함을 이르는 말. ≪논어≫의 선진편(先進篇)에 나오는 말이다.
관포지교 : 관중과 포숙의 사귐이란 뜻으로, 우정이 아주 돈독한 친구 관계를 이르는 말.
괄목상대 : 눈을 비비고 상대편을 본다는 뜻으로, 남의 학식이나 재주가 놀랄 만큼 부쩍 늚을 이르는 말.
교각살우 : 소의 뿔을 바로잡으려다가 소를 죽인다는 뜻으로, 잘못된 점을 고치려다가 그 방법이나 정도가 지나쳐 오히려 일을 그르침을 이르는 말.
교언영색 : 아첨하는 말과 알랑거리는 태도.
구밀복검 : 입에는 꿀이 있고 배 속에는 칼이 있다는 뜻으로, 말로는 친한 듯하나 속으로는 해칠 생각이 있음을 이르는 말.
구우일모 : 아홉 마리의 소 가운데 박힌 하나의 털이란 뜻으로, 매우 많은 것 가운데 극히 적은 수를 이르는 말.
군계일학 : 닭의 무리 가운데에서 한 마리의 학이란 뜻으로, 많은 사람 가운데서 뛰어난 인물을 이르는 말. ≪진서(晉書)≫의 에 나오는 말이다.
권토중래 : 1.땅을 말아 일으킬 것 같은 기세로 다시 온다는 뜻으로, 한 번 실패하였으나 힘을 회복하...	2.어떤 일에 실패한 뒤에 힘을 가다듬어 다시 그 일에 착수함을 비유하여 이르는 말.	
근묵자흑 : 먹을 가까이하는 사람은 검어진다는 뜻으로, 나쁜 사람과 가까이 지내면 나쁜 버릇에 물들기 쉬움을 비유적으로 이르는 말.
금과옥조 : 금이나 옥처럼 귀중히 여겨 꼭 지켜야 할 법칙이나 규정.
금상첨화 : 비단 위에 꽃을 더한다는 뜻으로, 좋은 일 위에 또 좋은 일이 더하여짐을 비유적으로 이르는 말. 왕안석의 글에서 유래한다.
기사회생 : 거의 죽을 뻔하다가 도로 살아남.
내우외한 : 역사 시문(詩文)을 평가하는 등급의 맨 꼴찌.
노심초사 : 몹시 마음을 쓰며 애를 태움.
누란지위 : 층층이 쌓아 놓은 알의 위태로움이라는 뜻으로, 몹시 아슬아슬한 위기를 비유적으로 이르는 말. ≪사기≫ 범저채택열전(范雎蔡澤列傳)에 나오는 말이다.
단도직입 : 1.혼자서 칼 한 자루를 들고 적진으로 곧장 쳐들어간다는 뜻으로, 여러 말을 늘어놓지 아...	2.불교생각과 분별과 말에 거리끼지 아니하고 진실의 경계로 바로 들어감.	
단사표음 : 대나무로 만든 밥그릇에 담은 밥과 표주박에 든 물이라는 뜻으로, 청빈하고 소박한 생활을 이르는 말.
단순호치 : 붉은 입술과 하얀 치아라는 뜻으로, 아름다운 여자를 이르는 말.
대기만성 : 큰 그릇을 만드는 데는 시간이 오래 걸린다는 뜻으로, 크게 될 사람은 늦게 이루어짐을 이르는 말.
동가홍상 : 같은 값이면 다홍치마라는 뜻으로, 같은 값이면 좋은 물건을 가짐을 이르는 말.
동병상련 : 같은 병을 앓는 사람끼리 서로 가엾게 여긴다는 뜻으로, 어려운 처지에 있는 사람끼리 서로 가엾게 여김을 이르는 말. ≪오월춘추≫의 합려내전(闔閭內傳)에 나온다.
동상이몽 : 1.같은 자리에 자면서 다른 꿈을 꾼다는 뜻으로, 겉으로는 같이 행동하면서도 속으로는 각...	2.[북한어]겉으로는 지지하고 받드는 척하면서 속으로는 반대함을 이르는 말.	
두문불출 : 1.집에만 있고 바깥출입을 아니함.	2.집에서 은거하면서 관직에 나가지 아니하거나 사회의 일을 하지 아니함을 비유적으로 이르는 말.	
마이동풍 : 동풍이 말의 귀를 스쳐 간다는 뜻으로, 남의 말을 귀담아듣지 아니하고 지나쳐 흘려버림을 이르는 말.
만시지탄 : 시기에 늦어 기회를 놓쳤음을 안타까워하는 탄식.
망양지탄 : 갈림길이 매우 많아 잃어버린 양을 찾을 길이 없음을 탄식한다는 뜻으로, 학문의 길이 여러 갈래여서 한 갈래의 진리도 얻기 어려움을 이르는 말.
망연자실 : 멍하니 정신을 잃음.
망운지정 : 자식이 객지에서 고향에 계신 어버이를 생각하는 마음.
맥수지탄 : 고국의 멸망을 한탄함을 이르는 말. 기자(箕子)가 은(殷)나라가 망한 뒤에도 보리만은 잘 자라는 것을 보고 한탄하였다는 데서 유래한다.
면종복배 : 겉으로는 복종하는 체하면서 내심으로는 배반함.
명경지수 : 1.맑은 거울과 고요한 물.	2.불교잡념과 가식과 헛된 욕심 없이 맑고 깨끗한 마음.	
명실상부 : 이름과 실상이 서로 꼭 맞음.
명약관화 : 불을 보듯 분명하고 뻔함. 
명재경각 : 거의 죽게 되어 곧 숨이 끊어질 지경에 이름.
무념무상 : 불교 무아의 경지에 이르러 일체의 상념을 떠남.
무릉도원 : 문학 도연명의 에 나오는 말로, ‘이상향’, ‘별천지’를 비유적으로 이르는 말. 중국 진(晉)나라 때 호남(湖南) 무릉의 한 어부가 배를 저어 복숭아꽃이 아름답게 핀 수원지로 올...
무위도식 : 하는 일 없이 놀고먹음.
문일지십 : 하나를 듣고 열 가지를 미루어 안다는 뜻으로, 지극히 총명함을 이르는 말. ≪논어≫의 공야장편(公冶長篇)에 나오는 말이다.
물아일체 : 철학 외물(外物)과 자아, 객관과 주관, 또는 물질계와 정신계가 어울려 하나가 됨.
반포지효 : 까마귀 새끼가 자라서 늙은 어미에게 먹이를 물어다 주는 효(孝)라는 뜻으로, 자식이 자란 후에 어버이의 은혜를 갚는 효성을 이르는 말.
발본색원 : 좋지 않은 일의 근본 원인이 되는 요소를 완전히 없애 버려서 다시는 그러한 일이 생길 수 없도록 함. ≪춘추좌씨전≫에 나온 말이다.
백년하청 : 중국의 황허 강(黃河江)이 늘 흐려 맑을 때가 없다는 뜻으로, 아무리 오랜 시일이 지나도 어떤 일이 이루어지기 어려움을 이르는 말.
백면서생 : 한갓 글만 읽고 세상일에는 전혀 경험이 없는 사람.
백척간두 : 백 자나 되는 높은 장대 위에 올라섰다는 뜻으로, 몹시 어렵고 위태로운 지경을 이르는 말.
벽사진경 : 요사스러운 잡귀를 물리치고 경사로 나아감.
본말전도 : 일이 처음과 나중이 뒤바뀜.
부창부수 : 남편이 주장하고 아내가 이에 잘 따름. 또는 부부 사이의 그런 도리.
부화뇌동 : 줏대 없이 남의 의견에 따라 움직임.
분골쇄신 : 1.뼈를 가루로 만들고 몸을 부순다는 뜻으로, 정성으로 노력함을 이르는 말. 또는 그렇게 ...	2.참혹하게 죽음.	
불문가지 : 묻지 아니하여도 알 수 있음.
불문곡직 : 옳고 그름을 따지지 아니함.
비옥가봉 : 집집마다 덕행이 있어 모두 표창할 만하다는 뜻으로, 나라에 어진 사람이 많음을 비유적으로 이르는 말.
비일비재 : 같은 현상이나 일이 한두 번이나 한둘이 아니고 많음.
사고무친 : 의지할 만한 사람이 아무도 없음.
사면초가 : 아무에게도 도움을 받지 못하는, 외롭고 곤란한 지경에 빠진 형편을 이르는 말. 초나라 항우가 사면을 둘러싼 한나라 군사 쪽에서 들려오는 초나라의 노랫소리를 듣고 초나라 군사...
사상누각 : 모래 위에 세운 누각이라는 뜻으로, 기초가 튼튼하지 못하여 오래 견디지 못할 일이나 물건을 이르는 말.
사필귀정 : 모든 일은 반드시 바른길로 돌아감.
살신성인 : 자기의 몸을 희생하여 인(仁)을 이룸. ≪논어≫의 에 나오는 말이다.
삼고초려 : 인재를 맞아들이기 위하여 참을성 있게 노력함. 중국 삼국 시대에, 촉한의 유비가 난양(南陽)에 은거하고 있던 제갈량의 초옥으로 세 번이나 찾아갔다는 데서 유래한다.
상부상조 : 서로서로 도움.
상전벽해 : 뽕나무밭이 변하여 푸른 바다가 된다는 뜻으로, 세상일의 변천이 심함을 비유적으로 이르는 말.
새옹지마 : 인생의 길흉화복은 변화가 많아서 예측하기가 어렵다는 말. 옛날에 새옹이 기르던 말이 오랑캐 땅으로 달아나서 노인이 낙심하였는데, 그 후에 달아났던 말이 준마를 한 필 끌고 와...
선남선녀 : 1.성품이 착한 남자와 여자란 뜻으로, 착하고 어진 사람들을 이르는 말.	2.곱게 단장을 한 남자와 여자를 이르는 말.	3.불교불법에 귀의한 남자와 여자를 이르는 말.	
설상가상 : 눈 위에 서리가 덮인다는 뜻으로, 난처한 일이나 불행한 일이 잇따라 일어남을 이르는 말.
소탐대실 : 작은 것을 탐하다가 큰 것을 잃음.
속수무책 : 손을 묶은 것처럼 어찌할 도리가 없어 꼼짝 못 함.
수구초심 : 여우가 죽을 때에 머리를 자기가 살던 굴 쪽으로 둔다는 뜻으로, 고향을 그리워하는 마음을 이르는 말.
수불석권 : 손에서 책을 놓지 아니하고 늘 글을 읽음.
수주대토 : 한 가지 일에만 얽매여 발전을 모르는 어리석은 사람을 비유적으로 이르는 말. 중국 송나라의 한 농부가 우연히 나무 그루터기에 토끼가 부딪쳐 죽은 것을 잡은 후, 또 그와 같이 토...
순망치한 : 입술이 없으면 이가 시리다는 뜻으로, 서로 이해관계가 밀접한 사이에 어느 한쪽이 망하면 다른 한쪽도 그 영향을 받아 온전하기 어려움을 이르는 말.
시기상조 : 어떤 일을 하기에 아직 때가 이름.
식자우환 : 학식이 있는 것이 오히려 근심을 사게 됨.
실사구시 : 철학 사실에 토대를 두어 진리를 탐구하는 일. 공리공론을 떠나서 정확한 고증을 바탕으로 하는 과학적ㆍ객관적 학문 태도를 이른 것으로, 중국 청나라 고증학의 학문 태도에서 볼...
심기일전 : 어떤 동기가 있어 이제까지 가졌던 마음가짐을 버리고 완전히 달라짐.
십시일반 : 밥 열 술이 한 그릇이 된다는 뜻으로, 여러 사람이 조금씩 힘을 합하면 한 사람을 돕기 쉬움을 이르는 말.
아연실색 : 뜻밖의 일에 얼굴빛이 변할 정도로 놀람. ‘크게 놀람’으로 순화.
아전인수 : 자기 논에 물 대기라는 뜻으로, 자기에게만 이롭게 되도록 생각하거나 행동함을 이르는 말.
안분지족 : 편안한 마음으로 제 분수를 지키며 만족할 줄을 앎.
안빈낙도 : 가난한 생활을 하면서도 편안한 마음으로 도를 즐겨 지킴.
안하무인 : 눈 아래에 사람이 없다는 뜻으로, 방자하고 교만하여 다른 사람을 업신여김을 이르는 말.
애이불비 : 1.슬프지만 겉으로는 슬픔을 나타내지 아니함.	2.슬프기는 하나 비참하지는 아니함.	
양두구육 : 양의 머리를 걸어 놓고 개고기를 판다는 뜻으로, 겉보기만 그럴듯하게 보이고 속은 변변하지 아니함을 이르는 말.
어불성설 : 말이 조금도 사리에 맞지 아니함.
역지사지 : 처지를 바꾸어서 생각하여 봄.
연목구어 : 나무에 올라가서 물고기를 구한다는 뜻으로, 도저히 불가능한 일을 굳이 하려 함을 비유적으로 이르는 말.
염량세태 : 세력이 있을 때는 아첨하여 따르고 세력이 없어지면 푸대접하는 세상인심을 비유적으로 이르는 말.
오리무중 : 오 리나 되는 짙은 안개 속에 있다는 뜻으로, 무슨 일에 대하여 방향이나 갈피를 잡을 수 없음을 이르는 말. ≪후한서≫의 장해전(張楷傳)에 나오는 말이다.
오매불망 : 자나 깨나 잊지 못함.
오월동주 : 서로 적의를 품은 사람들이 한자리에 있게 된 경우나 서로 협력하여야 하는 상황을 비유적으로 이르는 말. 중국 춘추 전국 시대에, 서로 적대시하는 오나라 사람과 월나라 사람이 같...
은고지신 : 땅을 다스리는 신령.
와신상담 : 불편한 섶에 몸을 눕히고 쓸개를 맛본다는 뜻으로, 원수를 갚거나 마음먹은 일을 이루기 위하여 온갖 어려움과 괴로움을 참고 견딤을 비유적으로 이르는 말. 
용두사미 : 용의 머리와 뱀의 꼬리라는 뜻으로, 처음은 왕성하나 끝이 부진한 현상을 이르는 말.
우이독경 : 쇠귀에 경 읽기라는 뜻으로, 아무리 가르치고 일러 주어도 알아듣지 못함을 이르는 말.
우화등선 : 사람의 몸에 날개가 돋아 하늘로 올라가 신선이 됨. ≪진서(晉書)≫의 에 나오는 말이다.
원화소복 : 화를 물리치고 복을 불러들임.
유명무실 : 이름만 그럴듯하고 실속은 없음.
유방백세 : 꽃다운 이름이 후세에 길이 전함.
유비무환 : 미리 준비가 되어 있으면 걱정할 것이 없음. ≪서경≫의 열명편에 나오는 말이다.
유유상종 : 같은 무리끼리 서로 사귐.
유유자적 : 속세를 떠나 아무 속박 없이 조용하고 편안하게 삶.
유취만년 : 더러운 이름을 후세에 오래도록 남김.
음풍농월 : 맑은 바람과 밝은 달을 대상으로 시를 짓고 흥취를 자아내어 즐겁게 놂.
이심전심 : 마음과 마음으로 서로 뜻이 통함. ≪전등록≫에 나오는 말로 원래는 불교의 법통을 계승할 때에 쓰였다.
이여반장 : 손바닥을 뒤집는 일처럼, 아주 쉬운 일을 비유하여 이르는 말.
이열치열 : 열은 열로써 다스림. 곧 열이 날 때에 땀을 낸다든지, 더위를 뜨거운 차를 마셔서 이긴다든지, 힘은 힘으로 물리친다는 따위를 이를 때에 흔히 쓰는 말이다.
우용후생 : 1.사람들의 생활을 넉넉하고 윤택하게 하는 일.	2.건강을 유지하거나 좋게 하는 일.	
인과응보 : 불교 전생에 지은 선악에 따라 현재의 행과 불행이 있고, 현세에서의 선악의 결과에 따라 내세에서 행과 불행이 있는 일.
인구회자 : 널리 여러 사람의 입에 오르내림을 이르는 말.
인면수심 : 사람의 얼굴을 하고 있으나 마음은 짐승과 같다는 뜻으로, 마음이나 행동이 몹시 흉악함을 이르는 말.
일망무제 : 한눈에 바라볼 수 없을 정도로 아득하게 멀고 넓어서 끝이 없음.
일장춘몽 : 1.한바탕의 봄꿈이라는 뜻으로, 헛된 영화나 덧없는 일을 비유적으로 이르는 말.	2.음악[같은 말] 탐경가(단가의 하나).	
일취월장 : 나날이 다달이 자라거나 발전함.
입신양명 : 출세하여 이름을 세상에 떨침.
자가당착 : 같은 사람의 말이나 행동이 앞뒤가 서로 맞지 아니하고 모순됨.
자강불식 : 스스로 힘써 몸과 마음을 가다듬어 쉬지 아니함.
자격지심 : 자기가 한 일에 대하여 스스로 미흡하게 여기는 마음.
자업자득 : 자기가 저지른 일의 결과를 자기가 받음.
작심삼일 : 단단히 먹은 마음이 사흘을 가지 못한다는 뜻으로, 결심이 굳지 못함을 이르는 말.
적반하장 : 도둑이 도리어 매를 든다는 뜻으로, 잘못한 사람이 아무 잘못도 없는 사람을 나무람을 이르는 말.
제자가인 : 1.[같은 말] 미인1(美人)(1. 아름다운 사람).	2.이성으로서 애정을 느끼게 하는 사람.	
전대미문 : 이제까지 들어 본 적이 없음.
전전긍긍 : 몹시 두려워서 벌벌 떨며 조심함. ≪시경≫의 에서 유래한다.
전전반측 : 누워서 몸을 이리저리 뒤척이며 잠을 이루지 못함.
전화위복 : 재앙과 화난이 바뀌어 오히려 복이 됨.
절차탁마 : 옥이나 돌 따위를 갈고 닦아서 빛을 낸다는 뜻으로, 부지런히 학문과 덕행을 닦음을 이르는 말. ≪시경≫의  과 ≪논어≫의 에 나오는 말이다.
절치부심 : 몹시 분하여 이를 갈며 속을 썩임.
점입가경 : 1.들어갈수록 점점 재미가 있음.	2.시간이 지날수록 하는 짓이나 몰골이 더욱 꼴불견임을 비유적으로 이르는 말.	
정문일침 : 정수리에 침을 놓는다는 뜻으로, 따끔한 충고나 교훈을 이르는 말.
정저지와 : 우물 안 개구리. 세상 견문이 좁음
조령모개 : 아침에 명령을 내렸다가 저녁에 다시 고친다는 뜻으로, 법령을 자꾸 고쳐서 갈피를 잡기가 어려움을 이르는 말. ≪사기≫의 에 나오는 말이다.
조변석개 : 아침저녁으로 뜯어고친다는 뜻으로, 계획이나 결정 따위를 일관성이 없이 자주 고침을 이르는 말.
조삼모사 : 1.간사한 꾀로 남을 속여 희롱함을 이르는 말. 중국 송나라의 저공(狙公)의 고사로, 먹이를...	2.[북한어]‘생계(살림을 살아 나갈 방도)’의 북한어.	
좌불안석 : 앉아도 자리가 편안하지 않다는 뜻으로, 마음이 불안하거나 걱정스러워서 한군데에 가만히 앉아 있지 못하고 안절부절못하는 모양을 이르는 말.
좌정관천 : 우물 속에 앉아서 하늘을 본다는 뜻으로, 사람의 견문(見聞)이 매우 좁음을 이르는 말.
주객일체 : 주체와 객체가 하나가 됨.
주객전도 : 주인과 손의 위치가 서로 뒤바뀐다는 뜻으로, 사물의 경중ㆍ선후ㆍ완급 따위가 서로 뒤바뀜을 이르는 말.
주경야독 : 낮에는 농사짓고, 밤에는 글을 읽는다는 뜻으로, 어려운 여건 속에서도 꿋꿋이 공부함을 이르는 말.
주마가편 : 달리는 말에 채찍질한다는 뜻으로, 잘하는 사람을 더욱 장려함을 이르는 말.
주마간산 : 말을 타고 달리며 산천을 구경한다는 뜻으로, 자세히 살피지 아니하고 대충대충 보고 지나감을 이르는 말.
죽마고우 : 대말을 타고 놀던 벗이라는 뜻으로, 어릴 때부터 같이 놀며 자란 벗.
중구난방 : 뭇사람의 말을 막기가 어렵다는 뜻으로, 막기 어려울 정도로 여럿이 마구 지껄임을 이르는 말. ‘마구 떠듦’으로 순화.
중언부언 : 이미 한 말을 자꾸 되풀이함. 또는 그런 말.
진퇴양난 : 이러지도 저러지도 못하는 어려운 처지.
창해일속 : 넓고 큰 바닷속의 좁쌀 한 알이라는 뜻으로, 아주 많거나 넓은 것 가운데 있는 매우 하찮고 작은 것을 이르는 말. 중국 북송의 문인 소식의 전적벽부(前赤壁賦)에 나오는 말이다.
천석고황 : 자연의 아름다운 경치를 몹시 사랑하고 즐기는 성벽(性癖.
천우신조 : 하늘이 돕고 신령이 도움. 또는 그런 일.
천의무봉 : 1.천사의 옷은 꿰맨 흔적이 없다는 뜻으로, 일부러 꾸민 데 없이 자연스럽고 아름다우면서...	2.완전무결하여 흠이 없음을 이르는 말.	3.세상사에 물들지 아니한 어린이와 같은 순진함을 이르는 말.	
천인공노 : 하늘과 사람이 함께 노한다는 뜻으로, 누구나 분노할 만큼 증오스럽거나 도저히 용납할 수 없음을 이르는 말.
천재일우 : 천 년 동안 단 한 번 만난다는 뜻으로, 좀처럼 만나기 어려운 좋은 기회를 이르는 말.
청출어람 : 쪽에서 뽑아낸 푸른 물감이 쪽보다 더 푸르다는 뜻으로, 제자나 후배가 스승이나 선배보다 나음을 비유적으로 이르는 말. ≪순자(荀子)≫의 에 나오는 말이다.
초록동색 : 풀빛과 녹색은 같다는 뜻으로, 이름은 달라도 성질이나 내용은 같나는 뜻. 어울려 같이 지내는 것들은 모두 같은 성격의 무리라는 뜻.
촌철살인 : 한 치의 쇠붙이로도 사람을 죽일 수 있다는 뜻으로, 간단한 말로도 남을 감동하게 하거나 남의 약점을 찌를 수 있음을 이르는 말.
출장입상 : 나가서는 장수가 되고 들어와서는 재상이 된다는 뜻으로, 문무를 다 갖추어 장상(將相)의 벼슬을 모두 지냄을 이르는 말.
칠종칠금 : 마음대로 잡았다 놓아주었다 함을 이르는 말. 중국 촉나라의 제갈량이 맹획(孟獲)을 일곱 번이나 사로잡았다가 일곱 번 놓아주었다는 데서 유래한다.
침소봉대 : 작은 일을 크게 불리어 떠벌림.
타산지석 : 다른 산의 나쁜 돌이라도 자신의 산의 옥돌을 가는 데에 쓸 수 있다는 뜻으로, 본이 되지 않은 남의 말이나 행동도 자신의 지식과 인격을 수양하는 데에 도움이 될 수 있음을 비유적...
토사구팽 : 토끼가 죽으면 토끼를 잡던 사냥개도 필요 없게 되어 주인에게 삶아 먹히게 된다는 뜻으로, 필요할 때는 쓰고 필요 없을 때는 야박하게 버리는 경우를 이르는 말.
파사현정 : 불교 사견(邪見)과 사도(邪道)를 깨고 정법(正法)을 드러내는 일. 삼론종의 근본 교의이다.
풍수지탄 : 효도를 다하지 못한 채 어버이를 여읜 자식의 슬픔을 이르는 말.
풍월조인 : 1.서로 약속하여 만든 문서에 도장을 찍음.	2.법률국제법상 조약 체결 때 조약 당사국의 대표자가 조약문에 동의하여 서명하는 일.	
풍전등화 : 1.바람 앞의 등불이라는 뜻으로, 사물이 매우 위태로운 처지에 놓여 있음을 비유적으로 이르는 말.	2.사물이 덧없음을 비유적으로 이르는 말.	
학수고대 : 학의 목처럼 목을 길게 빼고 간절히 기다림.
한우충동 : 짐으로 실으면 소가 땀을 흘리고, 쌓으면 들보에까지 찬다는 뜻으로, 가지고 있는 책이 매우 많음을 이르는 말.
한중진미 : 한가한 가운데 깃드는 참다운 맛.
함포고복 : 잔뜩 먹고 배를 두드린다는 뜻으로, 먹을 것이 풍족하여 즐겁게 지냄을 이르는 말.
허장성세 : 실속은 없으면서 큰소리치거나 허세를 부림.
형설지공 : 반딧불ㆍ눈과 함께 하는 노력이라는 뜻으로, 고생을 하면서 부지런하고 꾸준하게 공부하는 자세를 이르는 말. 중국≪진서(晉書)≫의 차윤전(車胤傳)ㆍ손강전(孫康傳)에 나오는 ...
호가호위 : 남의 권세를 빌려 위세를 부림. ≪전국책≫의 초책(楚策)에 나오는 말로 여우가 호랑이의 위세를 빌려 호기를 부린다는 데에서 유래한다.
호사다마 : 좋은 일에는 흔히 방해되는 일이 많음. 또는 그런 일이 많이 생김.
호연지기 : 1.하늘과 땅 사이에 가득 찬 넓고 큰 원기. ≪맹자≫ 의 상편에 나오는 말이다.	2.거침없이 넓고 큰 기개.	
혼정신성 : 밤에는 부모의 잠자리를 보아 드리고 이른 아침에는 부모의 밤새 안부를 묻는다는 뜻으로, 부모를 잘 섬기고 효성을 다함을 이르는 말.
홍익인간 : 널리 인간을 이롭게 함. 단군의 건국 이념으로서 우리나라 정치, 교육, 문화의 최고 이념이다. ≪삼국유사≫ 고조선 건국 신화에 나온다.
화룡점정 : 1.무슨 일을 하는 데에 가장 중요한 부분을 완성함을 비유적으로 이르는 말. 용을 그리고 ...	2.[북한어]글을 짓거나 일을 하는 데서 가장 요긴한 어느 한 대목을 잘함으로써 전체가 생...	

